     _____
    /     \
   /  ___  \
  |  |   |  |      THE ALAMO
  |  | † |  |    Remember 1836
  |__|___|__|   _______________
     | | |     |_______________|
   __| | |__   |_______________|
  |_________|  |_______________|
  ||  ___  ||  |_______________|
  || |___| ||  |_______________|
  ||_______||  |_______________|